AAAGAAATCTACATGACAGA	TCTGTCATGTAGATTTCTTT
CGAGTGTGAGACGGAATACG	CGTATTCCGTCTCACACTCG
CGGCTAGGATCAGTCAAGAT	ATCTTGACTGATCCTAGCCG
TCTATTTGTTGCTTGCGTTA	TAACGCAAGCAACAAATAGA
CCATCGACTATTGTACAGTC	GACTGTACAATAGTCGATGG
TTGAACTCAGAACATCTTTC	GAAAGATGTTCTGAGTTCAA
TATTGCCCCATATATGTTTT	AAAACATATATGGGGCAATA
TCATGCCTTCCCCAGCTGGG	CCCAGCTGGGGAAGGCATGA
GGCTCGACCTTGACCTCATG	CATGAGGTCAAGGTCGAGCC
TACATGACTCACGTAGTGCT	AGCACTACGTGAGTCATGTA
AGTGGTTGATCTGATGGTTC	GAACCATCAGATCAACCACT
TCAGGCCGGCACTGTTCGCT	AGCGAACAGTGCCGGCCTGA
AATACACGCGAGACCACATG	CATGTGGTCTCGCGTGTATT
TGATTTGGGGGCCTCGTCCT	AGGACGAGGCCCCCAAATCA
ACTGATAGGGTCAAGAAGGT	ACCTTCTTGACCCTATCAGT
ATAGGTAAACAATGTGTGCC	GGCACACATTGTTTACCTAT
CGATGAAAATGCGCTGCGTC	GACGCAGCGCATTTTCATCG
TGGACAGGCCCAGCGTGTAG	CTACACGCTGGGCCTGTCCA
ACAGGAAAGGGGCTCTTGCA	TGCAAGAGCCCCTTTCCTGT
GGTTCTATCTAGCGGTGCCC	GGGCACCGCTAGATAGAACC
GTCTTAACGGATATATTTCG	CGAAATATATCCGTTAAGAC
GGTCCAATAATATCGATCTG	CAGATCGATATTATTGGACC
ACGGGGAAATAGAACAGGTG	CACCTGTTCTATTTCCCCGT
GGAGAGCCACTATCACAGTC	GACTGTGATAGTGGCTCTCC
AATGCTGGAATCCCGATGTC	GACATCGGGATTCCAGCATT
GTAAGCGTACCCCTCACCCG	CGGGTGAGGGGTACGCTTAC
CGAAGATTCTCTGCGGGGTG	CACCCCGCAGAGAATCTTCG
TCGGTCGATAGCTACCAAGC	GCTTGGTAGCTATCGACCGA
TCGATGCATCTGCGATGGGA	TCCCATCGCAGATGCATCGA
GGCGACCTCTAGGGCCGTAC	GTACGGCCCTAGAGGTCGCC
GCGTGATCTGGAGACAACAC	GTGTTGTCTCCAGATCACGC
CTCCGACGCGGACTCCATTT	AAATGGAGTCCGCGTCGGAG
AGAAGTTCCCACGATCTCCT	AGGAGATCGTGGGAACTTCT
GTATGATTCCAAATTTCCGA	TCGGAAATTTGGAATCATAC
GCCAGATTCAGGGATTCGCA	TGCGAATCCCTGAATCTGGC
CCATTTATTTGCACGCTCCT	AGGAGCGTGCAAATAAATGG
CTGTTACCCTACGCCCCCTC	GAGGGGGCGTAGGGTAACAG
TAAGGAGGCCTTTGCGTCGT	ACGACGCAAAGGCCTCCTTA
CCCCCATTGTTCATGTATAA	TTATACATGAACAATGGGGG
CTTTCCATCGCAAAGACGGT	ACCGTCTTTGCGATGGAAAG
CACCTCCAGACATAAGTCCG	CGGACTTATGTCTGGAGGTG
AGTGAGTAGGGTCAGCTAGG	CCTAGCTGACCCTACTCACT
GCCCTCTGAGTTATTGCTCA	TGAGCAATAACTCAGAGGGC
ATCTGTACACCTTGGCCGGG	CCCGGCCAAGGTGTACAGAT
CACACTATCTTGTGGTACTT	AAGTACCACAAGATAGTGTG
ACCCCGCAAATATTCGCGTG	CACGCGAATATTTGCGGGGT
CCATCTCCAACTGGACAACA	TGTTGTCCAGTTGGAGATGG
TGCTTACATCCACCCTCTAC	GTAGAGGGTGGATGTAAGCA
TCAGGTCACAATGAAGCTCG	CGAGCTTCATTGTGACCTGA
TGAATTTTCGGATTTACTCA	TGAGTAAATCCGAAAATTCA
TTTTCTCCTTTATTTCCAGT	ACTGGAAATAAAGGAGAAAA
CTCCAGAGAACCCCACGGCG	CGCCGTGGGGTTCTCTGGAG
TCTAAGGTATGTAAGGCCAA	TTGGCCTTACATACCTTAGA
TTGATATTCATAAGAACAAA	TTTGTTCTTATGAATATCAA
TAAATTTCAACGAGCACCCT	AGGGTGCTCGTTGAAATTTA
GAGCTGTGTGTCGCGAGTGA	TCACTCGCGACACACAGCTC
CTACGGTGATGCGTGTTTGG	CCAAACACGCATCACCGTAG
AAATAAGGTGTGGGCGGGCA	TGCCCGCCCACACCTTATTT
TTACTGTGGCCGCCGGTATG	CATACCGGCGGCCACAGTAA
CTTTAACTAGTTCTTCCAAC	GTTGGAAGAACTAGTTAAAG
AATTATTTGCTGTACGCAAT	ATTGCGTACAGCAAATAATT
GTTCGGTTTCCGAAGGCTGG	CCAGCCTTCGGAAACCGAAC
GCAAGAACGGATAAGCTGTA	TACAGCTTATCCGTTCTTGC
TAGCCACATTTTTGCCTGGA	TCCAGGCAAAAATGTGGCTA
TGCCCCAGGGATCAAGACTA	TAGTCTTGATCCCTGGGGCA
TCGTTTTATACAACTCGTAC	GTACGAGTTGTATAAAACGA
GCCTGAGTTCGTCTCCTCAA	TTGAGGAGACGAACTCAGGC
TTGGAAACAGAGAAACTAGA	TCTAGTTTCTCTGTTTCCAA
TGGATAGTCCGCGCAAGACG	CGTCTTGCGCGGACTATCCA
CACCATGCCGCCTTGGCATA	TATGCCAAGGCGGCATGGTG
ACTGTTACACGCATAAAAAC	GTTTTTATGCGTGTAACAGT
CGATTGATTTTCCCCTCCGT	ACGGAGGGGAAAATCAATCG
CACACAACACAAGAGCAATC	GATTGCTCTTGTGTTGTGTG
CTCGATCCATACAGCGTCAA	TTGACGCTGTATGGATCGAG
ATAGGGTGCGTTGGCCTGTT	AACAGGCCAACGCACCCTAT
TTTATGAAAGCGCTACCTTT	AAAGGTAGCGCTTTCATAAA
TTCTTTCAGTTCTCAAACTA	TAGTTTGAGAACTGAAAGAA
TGCCCAGATAGCCACCTATA	TATAGGTGGCTATCTGGGCA
TGTGTACCCACTAAACTATT	AATAGTTTAGTGGGTACACA
AGTGTTTCGGAATGCTTCAC	GTGAAGCATTCCGAAACACT
ATGCGGGGGCACCGACGTCA	TGACGTCGGTGCCCCCGCAT
CCACGGGATGGCGTCTGTTT	AAACAGACGCCATCCCGTGG
CAAGATAAATCACTAAGCCA	TGGCTTAGTGATTTATCTTG
TTGGGCAAGCTTTGGATTTT	AAAATCCAAAGCTTGCCCAA
ATATCCACTTAGTCTTTAGC	GCTAAAGACTAAGTGGATAT
CCCCCAACTCTATGGAGTCA	TGACTCCATAGAGTTGGGGG
ACTCATTTGTAAACTGTAGT	ACTACAGTTTACAAATGAGT
GAAAAAATGTCCGCGGCTCG	CGAGCCGCGGACATTTTTTC
GCAATCCATCACAATGAGAC	GTCTCATTGTGATGGATTGC
AGTTGTATGCGGCCCGCGCC	GGCGCGGGCCGCATACAACT
TATAGGCTGTAGGGTGTCAT	ATGACACCCTACAGCCTATA
ACATACTTCGACCATCACTC	GAGTGATGGTCGAAGTATGT
TGCAGCAGGCCTCCGATCCA	TGGATCGGAGGCCTGCTGCA
CGCGTTAACGCAAAAGCAGA	TCTGCTTTTGCGTTAACGCG
TTACTATCCGGAGGTAGAGT	ACTCTACCTCCGGATAGTAA
GTGCCCCTTTTACGCAATAC	GTATTGCGTAAAAGGGGCAC
ATGTTGAGCCCCCGACATCT	AGATGTCGGGGGCTCAACAT
GGGTATAGAAGTTTATCTAC	GTAGATAAACTTCTATACCC
ATCACGCACTTGACATTGAC	GTCAATGTCAAGTGCGTGAT
GAGGCAACCGATCTGTGAAC	GTTCACAGATCGGTTGCCTC
TATAATAGTCATCGCGGCCC	GGGCCGCGATGACTATTATA
AACCACGTACCACCCGTTGC	GCAACGGGTGGTACGTGGTT
AGCTTAAGCATTTGTCTGGC	GCCAGACAAATGCTTAAGCT
GATGAAATCTAGGGCATCTA	TAGATGCCCTAGATTTCATC
TGGGAACCGAGGTTAGAACG	CGTTCTAACCTCGGTTCCCA
ATTAGGCGGCGATCGTCGCA	TGCGACGATCGCCGCCTAAT
GTGATTCAGATCGACCTACT	AGTAGGTCGATCTGAATCAC
GACCACTCAGTCTTAGGTAC	GTACCTAAGACTGAGTGGTC
TGTGGCCACGGACTTAAGCG	CGCTTAAGTCCGTGGCCACA
ATACTTATATGCCTAGAGAT	ATCTCTAGGCATATAAGTAT
TTTGGCTAATAATAAACTAT	ATAGTTTATTATTAGCCAAA
CGGGCCCTCAACCCGGCCTT	AAGGCCGGGTTGAGGGCCCG
TCGGAGCGCTGAGACCCATT	AATGGGTCTCAGCGCTCCGA
GGTAGCTAACCGGACGTGAA	TTCACGTCCGGTTAGCTACC
GGGTGTCTGGGGTCCTTTAC	GTAAAGGACCCCAGACACCC
GCCCGTATTCGATGCCACAT	ATGTGGCATCGAATACGGGC
GATTTCTGCCCGTTTGGTGC	GCACCAAACGGGCAGAAATC
CTGGGCGCGTGTGTATCCGG	CCGGATACACACGCGCCCAG
AAAAGCTTCCATTGGGAGGA	TCCTCCCAATGGAAGCTTTT
AGTCCTGGGCAGGAGAAGGT	ACCTTCTCCTGCCCAGGACT
TTGCGTACGCCGTCGACTCT	AGAGTCGACGGCGTACGCAA
CGACGCCTAGCGAAGGGTTC	GAACCCTTCGCTAGGCGTCG
GCAAGCGCACACGCGTGAAT	ATTCACGCGTGTGCGCTTGC
TAACTTCGAGCCTACCAGCA	TGCTGGTAGGCTCGAAGTTA
ACGCAATAGTCCTAGAGAAT	ATTCTCTAGGACTATTGCGT
TTTTCATGTTTTACAACAGA	TCTGTTGTAAAACATGAAAA
GCCTCCGACCGACGACTGCG	CGCAGTCGTCGGTCGGAGGC
GATATTTGTTTCATTACTGA	TCAGTAATGAAACAAATATC
GTACAAATATACCTGGGTCG	CGACCCAGGTATATTTGTAC
ATAGAATCAGCTTGTTTCTC	GAGAAACAAGCTGATTCTAT
TTTCAAAGAGTGAAGCTTAT	ATAAGCTTCACTCTTTGAAA
GCCACATGAGACAAATGCAC	GTGCATTTGTCTCATGTGGC
TAGAGGACTGTCCTATGCTG	CAGCATAGGACAGTCCTCTA
ATGCGAGATGGTGAGCAGCC	GGCTGCTCACCATCTCGCAT
TACTAACCGGGGACCTCGAA	TTCGAGGTCCCCGGTTAGTA
GTACTATCGGAAAAAACTGT	ACAGTTTTTTCCGATAGTAC
AGGAATAATACGGCGCACGG	CCGTGCGCCGTATTATTCCT
CGTCTCGACCTGACTGCCCA	TGGGCAGTCAGGTCGAGACG
GCCGGCACTCCGGTAGGGAG	CTCCCTACCGGAGTGCCGGC
ACCGTGCCAAGGTCTAAATT	AATTTAGACCTTGGCACGGT
CGCGTCATAGATCAGCCTCC	GGAGGCTGATCTATGACGCG
CACTTCTACTCTTGGTACTC	GAGTACCAAGAGTAGAAGTG
GTCGCGGTGGCTATCACTAA	TTAGTGATAGCCACCGCGAC
CGACGTATATCGTGCACCGA	TCGGTGCACGATATACGTCG
GCTGTCACGATCAGACAGCC	GGCTGTCTGATCGTGACAGC
GTCTCGGAGACGGTAAAAGT	ACTTTTACCGTCTCCGAGAC
CATCCCCCCGTCCTATTTTC	GAAAATAGGACGGGGGGATG
CAAATTGATCTTATCTTGAC	GTCAAGATAAGATCAATTTG
TGTCCATGAGTCATTCCTCG	CGAGGAATGACTCATGGACA
AGACTCCTCGCGTTATCTTA	TAAGATAACGCGAGGAGTCT
GTTTTTGGTGTCCTGCGTTG	CAACGCAGGACACCAAAAAC
TGGTACGAAGCATGAATAAA	TTTATTCATGCTTCGTACCA
GCCCCCGGGCAGTCGTCATA	TATGACGACTGCCCGGGGGC
TAATCTGTAAGTAAGAGTAC	GTACTCTTACTTACAGATTA
CAAAAAATCACGACTCTGGC	GCCAGAGTCGTGATTTTTTG
AATTACTTTGCTGTTACTCG	CGAGTAACAGCAAAGTAATT
ATTGGTCAGACGTTCATTAC	GTAATGAACGTCTGACCAAT
GGGGGCTGCATGCTCGAGAC	GTCTCGAGCATGCAGCCCCC
TCGTTCAACGGGCTGTTTGA	TCAAACAGCCCGTTGAACGA
AACAAATTGAGGTTTCTGCC	GGCAGAAACCTCAATTTGTT
CCTCCATCTTTAGCTGTAAA	TTTACAGCTAAAGATGGAGG
TCTAGCTACTAGGACTCACA	TGTGAGTCCTAGTAGCTAGA
ACAATGGTTAACGAACGTGG	CCACGTTCGTTAACCATTGT
AAATGCTTACTCGCATGGGG	CCCCATGCGAGTAAGCATTT
TCTCGGGCGGTGGCCGTCGC	GCGACGGCCACCGCCCGAGA
TAGGTTCATACAACATAACG	CGTTATGTTGTATGAACCTA
GGCGATCTCACTCATTAGAT	ATCTAATGAGTGAGATCGCC
ATATTCGAAGGGACCCGAAA	TTTCGGGTCCCTTCGAATAT
TTGTATCCCGTGGTAAGACT	AGTCTTACCACGGGATACAA
CTATAGGAGAATTGGAGGCA	TGCCTCCAATTCTCCTATAG
TTAGATAAAAGTCGCAAGAA	TTCTTGCGACTTTTATCTAA
TTCGAGCATATCAACCGCAA	TTGCGGTTGATATGCTCGAA
GTATAGAGTCATTTAATCGC	GCGATTAAATGACTCTATAC
AATGCAAACCCCCCTATTGC	GCAATAGGGGGGTTTGCATT
TCCCGATTCGGCTAGAAGGC	GCCTTCTAGCCGAATCGGGA
CCCCGGTTCAAAGTTTCTCA	TGAGAAACTTTGAACCGGGG
CGCGTTAATGCACTCAACAA	TTGTTGAGTGCATTAACGCG
GGACGTACGTCCGATGCACC	GGTGCATCGGACGTACGTCC
TAGATTCACACTCAGTTGGG	CCCAACTGAGTGTGAATCTA
GGACCCAGACGTGAAGTCAG	CTGACTTCACGTCTGGGTCC
CCTCAGTACTGCCAGATAAA	TTTATCTGGCAGTACTGAGG
ATCTAAGTCACTGAGCACAG	CTGTGCTCAGTGACTTAGAT
TCCCATGGGAGGGATATGAC	GTCATATCCCTCCCATGGGA
CCCATTTTTCTACTCTGGTG	CACCAGAGTAGAAAAATGGG
TCTTACCCCATCAGACCGGA	TCCGGTCTGATGGGGTAAGA
AGCCAGACTGGGACACCTTT	AAAGGTGTCCCAGTCTGGCT
TCTGTCTGTCCTAAAGACTG	CAGTCTTTAGGACAGACAGA
TTTACGCCCAATAAGGAGTG	CACTCCTTATTGGGCGTAAA
ACCGTAATGTGAGGAGGCGC	GCGCCTCCTCACATTACGGT
CTCTGCGTACTCTCTAATTG	CAATTAGAGAGTACGCAGAG
ACTATAGGCCCGCCTAGACA	TGTCTAGGCGGGCCTATAGT
GCTCGGATAGGTACTGCCAA	TTGGCAGTACCTATCCGAGC
TGCATTAACTAGTGGATGGC	GCCATCCACTAGTTAATGCA
CCACCACGTGGGCAACTGCA	TGCAGTTGCCCACGTGGTGG
CGCCTGAACGAGGCAATTTG	CAAATTGCCTCGTTCAGGCG
GCTTTCTCCGCACATCCCAT	ATGGGATGTGCGGAGAAAGC
AAGGCCGATGCTCTGGAAAC	GTTTCCAGAGCATCGGCCTT
GACGGAGTCGACTTAGGTCT	AGACCTAAGTCGACTCCGTC
TGGTCGGCTGGATCGTGTCT	AGACACGATCCAGCCGACCA
TACTGTTAGCTCATGCTCTG	CAGAGCATGAGCTAACAGTA
CCACGTAGAATTCAAATAAT	ATTATTTGAATTCTACGTGG
GTGCAACTGGGCTAATATAC	GTATATTAGCCCAGTTGCAC
GTGCGTGCAAGAACAACTAA	TTAGTTGTTCTTGCACGCAC
GAACCCCTTACTCATCATTT	AAATGATGAGTAAGGGGTTC
CTTTCCTGTTTATGTGGGAG	CTCCCACATAAACAGGAAAG
GTTAGCGACAGTCGGATTAC	GTAATCCGACTGTCGCTAAC
GTTTCTGTAAGATAGGCGAT	ATCGCCTATCTTACAGAAAC
CACTCTTATTGTTAGGATCA	TGATCCTAACAATAAGAGTG
CGCCACGGAATGTGCTAAGG	CCTTAGCACATTCCGTGGCG
TCGCATAGGGAGCAGACAGA	TCTGTCTGCTCCCTATGCGA
AGTTGTGTGCGTTTCCCCAT	ATGGGGAAACGCACACAACT
TGCAAACGGGTACAAATCGG	CCGATTTGTACCCGTTTGCA
AGAGGAGATGACTACGCTGG	CCAGCGTAGTCATCTCCTCT
TTATGTATCATGCTGTGCTA	TAGCACAGCATGATACATAA
GCCTGCCCCAACGCAACCGT	ACGGTTGCGTTGGGGCAGGC
GTCCAAGGGCGTTGTCAAAT	ATTTGACAACGCCCTTGGAC
TGCCGCGAGCTCTCTTACTG	CAGTAAGAGAGCTCGCGGCA
AATACCACTAATCCACCTGT	ACAGGTGGATTAGTGGTATT
ATTTACTGCCAATATGATTG	CAATCATATTGGCAGTAAAT
GTTAGCCGCATACATACCTG	CAGGTATGTATGCGGCTAAC
CGTACGCACCGTATCTCAAT	ATTGAGATACGGTGCGTACG
GCGGTTCTTCCGAATGGGGT	ACCCCATTCGGAAGAACCGC
CCTTGCAACAGCTATTCGGC	GCCGAATAGCTGTTGCAAGG
GGTAGTCACTTCTGCGCCGC	GCGGCGCAGAAGTGACTACC
GCTTTCGCAGACTAAACTGG	CCAGTTTAGTCTGCGAAAGC
TTTACGGCTGCGTCTTTCCG	CGGAAAGACGCAGCCGTAAA
TCATGGATCCGCGTAGCTTA	TAAGCTACGCGGATCCATGA
TTGCGTTTTACTAATGGCTC	GAGCCATTAGTAAAACGCAA
CGGTGGACTCTTGACCTCAG	CTGAGGTCAAGAGTCCACCG
CGTCGTGTAAATTTCACATT	AATGTGAAATTTACACGACG
CTACTACCGTCACCCTAGGA	TCCTAGGGTGACGGTAGTAG
CGACGTAGAACAATGGTAGT	ACTACCATTGTTCTACGTCG
GATAAACTATCCCTATTCGA	TCGAATAGGGATAGTTTATC
TTGATACTCTATGGAGATTG	CAATCTCCATAGAGTATCAA
ATTAGTCTACAACGACGTGG	CCACGTCGTTGTAGACTAAT
TGGTTATTTAGAGCTTGAGA	TCTCAAGCTCTAAATAACCA
ACGAACCATAAAACTTAATG	CATTAAGTTTTATGGTTCGT
ACTGCGGACGGACGGCTAAC	GTTAGCCGTCCGTCCGCAGT
CCGTCCTGCAGTCACTGATC	GATCAGTGACTGCAGGACGG
GAATGCTCTAGAGACCCTTC	GAAGGGTCTCTAGAGCATTC
CGTTACAACTTTGTACATGT	ACATGTACAAAGTTGTAACG
CCGTGCCCTACAGCGTCAAC	GTTGACGCTGTAGGGCACGG
TCATCCAGAGCTATACAGCG	CGCTGTATAGCTCTGGATGA
AGGGAATAACGTTATCACGG	CCGTGATAACGTTATTCCCT
GCGGCGCTCAAGATTACGAC	GTCGTAATCTTGAGCGCCGC
TTTTAGTTGAGGAAGCCGGC	GCCGGCTTCCTCAACTAAAA
GAAACTCTCCGTATAACGCG	CGCGTTATACGGAGAGTTTC
TCAAGTGAAGGAAACTCAGC	GCTGAGTTTCCTTCACTTGA
AGAATAGCTTGGTGGCGGGC	GCCCGCCACCAAGCTATTCT
TAGGATCACTGGAGATAGTC	GACTATCTCCAGTGATCCTA
GCTCGGGAATGCCAGTCTAC	GTAGACTGGCATTCCCGAGC
GCCCTGGAATCACTCGAAGA	TCTTCGAGTGATTCCAGGGC
TCATCGGCGATAATAGAAAC	GTTTCTATTATCGCCGATGA
AGGTCTATCTACTATACGAG	CTCGTATAGTAGATAGACCT
CCTCGCACTTCTGGAAGTAA	TTACTTCCAGAAGTGCGAGG
CCGCAGCAGAGTATATAAGA	TCTTATATACTCTGCTGCGG
AGACGTACCGCCATAACTTA	TAAGTTATGGCGGTACGTCT
CAACTTGGGAGTCACTCTAG	CTAGAGTGACTCCCAAGTTG
ACGCGTCAAAATGTTTTTGT	ACAAAAACATTTTGACGCGT
TAGTTCGTAGGGATACCTGT	ACAGGTATCCCTACGAACTA
TTACGGGCACGGTTATAAAG	CTTTATAACCGTGCCCGTAA
CGTTAAGTGACCAACTCAGA	TCTGAGTTGGTCACTTAACG
ACGCCCCAAGAAGAGCAGCA	TGCTGCTCTTCTTGGGGCGT
CGGGAAACAGGGTCTACCTG	CAGGTAGACCCTGTTTCCCG
CTCGATTTACCGCATGTTAT	ATAACATGCGGTAAATCGAG
CCGTCACCGGGTGAAGATAT	ATATCTTCACCCGGTGACGG
TTTAGCTCTTTACTATGGAA	TTCCATAGTAAAGAGCTAAA
GTATTGGACGTGCTAGATAT	ATATCTAGCACGTCCAATAC
TGTTCCTTCGCGCATGGGCA	TGCCCATGCGCGAAGGAACA
TGACCGAAAGCCGTACTGCG	CGCAGTACGGCTTTCGGTCA
GCTGTCGCTATCTTTAACTC	GAGTTAAAGATAGCGACAGC
CTCAAGCGCGGTTGGTGCCG	CGGCACCAACCGCGCTTGAG
GGTCCGGCGGGGCATATGAC	GTCATATGCCCCGCCGGACC
TAGGTCTTGTATGCGAGTTC	GAACTCGCATACAAGACCTA
GAACGAATCCGCATACTGTA	TACAGTATGCGGATTCGTTC
ACTGGTCCCGAAGTCAGATC	GATCTGACTTCGGGACCAGT
AGGCTGGCTTCTGCCGCATT	AATGCGGCAGAAGCCAGCCT
GCGTCACACCATATCTCCGA	TCGGAGATATGGTGTGACGC
GGGGTATCCCCACACGACCT	AGGTCGTGTGGGGATACCCC
TATCTCGTTACACGGGATGG	CCATCCCGTGTAACGAGATA
CTGGTAAGAACTTTAAGCCC	GGGCTTAAAGTTCTTACCAG
CTAGGGTCCAGTAAGGGTGA	TCACCCTTACTGGACCCTAG
GCACCGCGGTTGCCGGGTAG	CTACCCGGCAACCGCGGTGC
CGTCGGTCGGCGCGTTCCCC	GGGGAACGCGCCGACCGACG
CTCTCTTTACCGCTGCGAGC	GCTCGCAGCGGTAAAGAGAG
CCTGGAGGCGTTCGTCCACC	GGTGGACGAACGCCTCCAGG
GGACTCATCCTTAAATATGC	GCATATTTAAGGATGAGTCC
CTTGACGTTACTGCACCGAG	CTCGGTGCAGTAACGTCAAG
GTAGCAGCTCTCCGGTTGCT	AGCAACCGGAGAGCTGCTAC
GAGAAACGGCACGTTGGTCC	GGACCAACGTGCCGTTTCTC
CAAGAGTGATACTGTTGAGG	CCTCAACAGTATCACTCTTG
TAGGTTAATTATAGTCAAGG	CCTTGACTATAATTAACCTA
GCAGATTTCGCACTGACCTA	TAGGTCAGTGCGAAATCTGC
AACGCGATTGGAGCTTATAA	TTATAAGCTCCAATCGCGTT
TGCTACAGTGCCAAGCGCCC	GGGCGCTTGGCACTGTAGCA
AAACATATACTGCAATGGAC	GTCCATTGCAGTATATGTTT
TACCTTGCGTTCTCTGAGTT	AACTCAGAGAACGCAAGGTA
GTATTTCCACCGCGTTAGGT	ACCTAACGCGGTGGAAATAC
CATCCGACCAACCGCAGGTG	CACCTGCGGTTGGTCGGATG
TGGGACATTTCACAGTCTGT	ACAGACTGTGAAATGTCCCA
CAAGTCGTCCGCTTATCTAA	TTAGATAAGCGGACGACTTG
AGATACGCTCGCACAACAGC	GCTGTTGTGCGAGCGTATCT
CCTTACCGTGTACATTCGAA	TTCGAATGTACACGGTAAGG
GTACGCTGCGAGTGATGTGT	ACACATCACTCGCAGCGTAC
CTGCGTCTAGGAATTTGGGC	GCCCAAATTCCTAGACGCAG
ATGTTATAGAGTTAGATTGG	CCAATCTAACTCTATAACAT
TTTAGACATGGACGTGGGAC	GTCCCACGTCCATGTCTAAA
CACATGCCAGCCCTGCCGGG	CCCGGCAGGGCTGGCATGTG
TTGATCCAACGAAGGATATT	AATATCCTTCGTTGGATCAA
ACAAACGGTGCACTCCCCAT	ATGGGGAGTGCACCGTTTGT
GCTGCCATCAGGGCAACATT	AATGTTGCCCTGATGGCAGC
ATGTCAGAATTCATGTCTAG	CTAGACATGAATTCTGACAT
GTGCATTAAGATCATCCCCG	CGGGGATGATCTTAATGCAC
ATCCGCGGTTTCAGCTAGTG	CACTAGCTGAAACCGCGGAT
ACCATCCACCATGGCGCGTT	AACGCGCCATGGTGGATGGT
TCGTAATTTCGGCAGACGCC	GGCGTCTGCCGAAATTACGA
GTTGCCGTAACCGGTCAAGG	CCTTGACCGGTTACGGCAAC
CACATATGCAAACTTTGCCC	GGGCAAAGTTTGCATATGTG
TCCTTCCAATGGCACTGGGG	CCCCAGTGCCATTGGAAGGA
AGATAGTTATTCCGATCGCC	GGCGATCGGAATAACTATCT
TGGCACTACATGTGCAGGGG	CCCCTGCACATGTAGTGCCA
AGGGGCTTACTACGGTGCCG	CGGCACCGTAGTAAGCCCCT
GCCACTGTGTTGCCCTGGGG	CCCCAGGGCAACACAGTGGC
ATGAGACGATGACTAAGGTT	AACCTTAGTCATCGTCTCAT
TATCGCGTGCTGTAAGATCG	CGATCTTACAGCACGCGATA
CACATTGACCTTCTGGCTAA	TTAGCCAGAAGGTCAATGTG
CCCCGGTCCGATATCTATAC	GTATAGATATCGGACCGGGG
GGAGACGAATGCACTCCCGG	CCGGGAGTGCATTCGTCTCC
GAAAAATTGTCTGCCAGCTA	TAGCTGGCAGACAATTTTTC
TGGATACTTAATGTACCCCC	GGGGGTACATTAAGTATCCA
TACTGGTCAGTGCGTCATAC	GTATGACGCACTGACCAGTA
CAAGATAGCTCCGAGTGGAG	CTCCACTCGGAGCTATCTTG
TAGCATTAACATCAAGTATG	CATACTTGATGTTAATGCTA
CTCTCCGTATCGGCATTCGT	ACGAATGCCGATACGGAGAG
CCTACTTGCTCAGCGACACC	GGTGTCGCTGAGCAAGTAGG
GAACTCTAGGGTTGTGTTCA	TGAACACAACCCTAGAGTTC
TAATGAGCTTGCAAAACTCA	TGAGTTTTGCAAGCTCATTA
AACTGTTCTTAACCTCCGGT	ACCGGAGGTTAAGAACAGTT
GAATAATTAGTGCCGAGGCC	GGCCTCGGCACTAATTATTC
TAGTATCCAAGCATTTATAA	TTATAAATGCTTGGATACTA
GTCTTCTCGTGAAGTCAGTC	GACTGACTTCACGAGAAGAC
TCCCCTATTGAAGTTGACCA	TGGTCAACTTCAATAGGGGA
TCTCGTTACGAGACCACCAT	ATGGTGGTCTCGTAACGAGA
CGAGGTCGCTACACGGTGGA	TCCACCGTGTAGCGACCTCG
GCGCGAATGGAGGGGAGTCA	TGACTCCCCTCCATTCGCGC
ATTACCCGCCTTCTTTAGCT	AGCTAAAGAAGGCGGGTAAT
GAACAGCTCTTATCCGATAA	TTATCGGATAAGAGCTGTTC
CCATTGACAAGCGTTACTGT	ACAGTAACGCTTGTCAATGG
GACAGACCAGGAATAGCGCC	GGCGCTATTCCTGGTCTGTC
CACTGAAGCATTGCGCAGCG	CGCTGCGCAATGCTTCAGTG
GGCGCACACCTCTCTGCATA	TATGCAGAGAGGTGTGCGCC
ATTGGACGCATTGAAGTATA	TATACTTCAATGCGTCCAAT
ACACATTTAGGTCGTAGTGG	CCACTACGACCTAAATGTGT
TCAGTATTTAAGCAGAATGT	ACATTCTGCTTAAATACTGA
GAAGGAAAACGCAACTGCAT	ATGCAGTTGCGTTTTCCTTC
TAACGTGAGGGTTGTTTGGA	TCCAAACAACCCTCACGTTA
TACGGTGCTGATCCCTAAGG	CCTTAGGGATCAGCACCGTA
TGAATTAATCTGGGTTTCCC	GGGAAACCCAGATTAATTCA
CTACAGGGGAATCTCGAGAC	GTCTCGAGATTCCCCTGTAG
AACCCGAGATTGAACAATGT	ACATTGTTCAATCTCGGGTT
TCACCCACTTAGGTCCACTA	TAGTGGACCTAAGTGGGTGA
AGCTCTGACTATTCCCCGGG	CCCGGGGAATAGTCAGAGCT
GTGGGGCTGACGCCTACGAT	ATCGTAGGCGTCAGCCCCAC
AGCTCACGTTGCGAGTACAG	CTGTACTCGCAACGTGAGCT
CGCAATAACTACTGGGAGAA	TTCTCCCAGTAGTTATTGCG
TGCGTAGGGTCACACCCAAG	CTTGGGTGTGACCCTACGCA
AAGGTCGAGTAGTCGGAGCT	AGCTCCGACTACTCGACCTT
TTCCCGTCGTTGGTCCCATC	GATGGGACCAACGACGGGAA
ACGTGTACACTGGCCTTGGC	GCCAAGGCCAGTGTACACGT
ATTGTCTTTTCCTCATTAGA	TCTAATGAGGAAAAGACAAT
CCTTACCGATCGTCTCGCGA	TCGCGAGACGATCGGTAAGG
GGATTGTTCGATGCCGTAGC	GCTACGGCATCGAACAATCC
GAACAAAATTGAATGTGCAT	ATGCACATTCAATTTTGTTC
CTTCTCGAAAGAACGCGTGT	ACACGCGTTCTTTCGAGAAG
TCTTGCCTTGGCGTTGCTTA	TAAGCAACGCCAAGGCAAGA
CCCCTGGGTACCCTTCACTG	CAGTGAAGGGTACCCAGGGG
GGCCTCCGGTCCGTTCGTAC	GTACGAACGGACCGGAGGCC
GCATCACGGACGGAGACGCT	AGCGTCTCCGTCCGTGATGC
TCTTGTGTCATTCCGTCTGT	ACAGACGGAATGACACAAGA
GTAACTGTTCGCCCATTGAA	TTCAATGGGCGAACAGTTAC
TAGACTCCTACCGGTCGGAG	CTCCGACCGGTAGGAGTCTA
CCTGTGCCCGTGCGACAAGT	ACTTGTCGCACGGGCACAGG
CAGTTGTTCGTGCTTTAGTC	GACTAAAGCACGAACAACTG
GGGCCCCGGCGGAATTGTAA	TTACAATTCCGCCGGGGCCC
ATAGAAGAGCGTTGTGCTCT	AGAGCACAACGCTCTTCTAT
CGTAATGGTGATTGATCGTC	GACGATCAATCACCATTACG
GTGCCATGCACTTGCACGGG	CCCGTGCAAGTGCATGGCAC
CCTTGGACCTGGTGACTTGC	GCAAGTCACCAGGTCCAAGG
CGGAAGACTCACTACCTGCG	CGCAGGTAGTGAGTCTTCCG
ACAACTTTCGATATGGCCTG	CAGGCCATATCGAAAGTTGT
GGCAAAGCTCGCACTAAACG	CGTTTAGTGCGAGCTTTGCC
TCGAAGCTACGTGTCGGACC	GGTCCGACACGTAGCTTCGA
CAGCAAGATGTCGCTATCGA	TCGATAGCGACATCTTGCTG
CAATCCACAGGTTGTTGGAA	TTCCAACAACCTGTGGATTG
TTCCCAATACTTACAGTGGA	TCCACTGTAAGTATTGGGAA
TACAGAGTCTTCATTCGATA	TATCGAATGAAGACTCTGTA
TCCCCTGACTCGGCCGTCCT	AGGACGGCCGAGTCAGGGGA
AATTCATGTAGTCCGGTAAC	GTTACCGGACTACATGAATT
CCATATTCTTCTAGAAAGTG	CACTTTCTAGAAGAATATGG
ACCACCTGATTCAGTGTCAC	GTGACACTGAATCAGGTGGT
GCTACTCCACGGTTGCGATT	AATCGCAACCGTGGAGTAGC
GATGACACGCGGAAGAGGCT	AGCCTCTTCCGCGTGTCATC
GTTGCGCACGCGTCTTTCAG	CTGAAAGACGCGTGCGCAAC
GCTATCCCATGTGAGTCACA	TGTGACTCACATGGGATAGC
CGGATACTGTTGGGCACACA	TGTGTGCCCAACAGTATCCG
TTATCGCTGCGGACGATTTC	GAAATCGTCCGCAGCGATAA
GATTGCCTGGAGGAGCGATT	AATCGCTCCTCCAGGCAATC
GGAGTCCTGATCACTTAAGA	TCTTAAGTGATCAGGACTCC
GCCGCGTACAAAACAAACAT	ATGTTTGTTTTGTACGCGGC
CGTGCCCGAGAATTACTGCG	CGCAGTAATTCTCGGGCACG
GTACTCGGGGCGACTAGATA	TATCTAGTCGCCCCGAGTAC
AACTTCTTAGGCACGCGAGA	TCTCGCGTGCCTAAGAAGTT
TAGGCTAACATAATTGTGTT	AACACAATTATGTTAGCCTA
TTTGAAAATGCAAGACCGGC	GCCGGTCTTGCATTTTCAAA
ATTTTGTAAGTAGATTAATA	TATTAATCTACTTACAAAAT
TGCGACATAACGGGCTGATC	GATCAGCCCGTTATGTCGCA
TCATCTCCACTGAAATCCTA	TAGGATTTCAGTGGAGATGA
CACTTCGCTTTTTAGGATGT	ACATCCTAAAAAGCGAAGTG
CCGATTGCCGGTCTGCCCAG	CTGGGCAGACCGGCAATCGG
TTTCTCTGGATCTTGTTCGT	ACGAACAAGATCCAGAGAAA
CAATCTCCAGAAGGTCTATG	CATAGACCTTCTGGAGATTG
GCGACTTGACGACTGACTAG	CTAGTCAGTCGTCAAGTCGC
GTCGCCGCAACCACCAGTGC	GCACTGGTGGTTGCGGCGAC
AGTGGTCGAAGGCGTGCCGG	CCGGCACGCCTTCGACCACT
GGGAACCTACGGCTCATCTA	TAGATGAGCCGTAGGTTCCC
CACAAGGGCACTTATCCTTA	TAAGGATAAGTGCCCTTGTG
GCAACTTAATGAGACTGCTA	TAGCAGTCTCATTAAGTTGC
CATCTCATACAGACCTTAAC	GTTAAGGTCTGTATGAGATG
CCCGTGAGCGGTCGCACATT	AATGTGCGACCGCTCACGGG
GTCTGATACCCCCCGTAGGG	CCCTACGGGGGGTATCAGAC
ATAGCGCCACTTTAGGCGAT	ATCGCCTAAAGTGGCGCTAT
AAGCCATGCTCCGATCTTGA	TCAAGATCGGAGCATGGCTT
ACTTTAATCTCTGATTGCGC	GCGCAATCAGAGATTAAAGT
GCCCCATTAAGATGGAATCG	CGATTCCATCTTAATGGGGC
ATTATTGCCTCATTTTAGCG	CGCTAAAATGAGGCAATAAT
AGGGTCTTGAGAGTGCCCGA	TCGGGCACTCTCAAGACCCT
GGACTATGGCGAGCCTTGGA	TCCAAGGCTCGCCATAGTCC
AATGAAAGTTCCTAGTCGAG	CTCGACTAGGAACTTTCATT
AACATCACATCAGGTGTGCG	CGCACACCTGATGTGATGTT
GGGAAGTTGTCTACGCGGGG	CCCCGCGTAGACAACTTCCC
CCGGTTGTCACTGTTTCAAG	CTTGAAACAGTGACAACCGG
ACGCTTACCAGCCGGCCTAA	TTAGGCCGGCTGGTAAGCGT
GCTTCAAACGAAGTAAAGTC	GACTTTACTTCGTTTGAAGC
CTCTCCGGCGATCTAGAATC	GATTCTAGATCGCCGGAGAG
GTAATAGCTGATCTCATGGC	GCCATGAGATCAGCTATTAC
CGCCGATGGCCTATATTACT	AGTAATATAGGCCATCGGCG
GGAACCGGTTTGGGACAAGC	GCTTGTCCCAAACCGGTTCC
GCACGATGGACCCAGCACAG	CTGTGCTGGGTCCATCGTGC
TCATTTCTAGCCCACTGGGC	GCCCAGTGGGCTAGAAATGA
AGTAGTTACTGATAGATGGG	CCCATCTATCAGTAACTACT
GAGAATTAGCGCACAGTGAA	TTCACTGTGCGCTAATTCTC
GAGGGGTAGGAAGAGTGCTA	TAGCACTCTTCCTACCCCTC
CCAACTTGGCTGCGCTATCA	TGATAGCGCAGCCAAGTTGG
CGTAGTTCTAAAGGCAGTTC	GAACTGCCTTTAGAACTACG
GTCTGCACTCCACCTTACTT	AAGTAAGGTGGAGTGCAGAC
CACCAATTAAAGCTCTCGGT	ACCGAGAGCTTTAATTGGTG
GATGTTGTATTACGGGGCCA	TGGCCCCGTAATACAACATC
GAACCACAAGAGACACGAGG	CCTCGTGTCTCTTGTGGTTC
TGCCGCGTGCTATAAATCAA	TTGATTTATAGCACGCGGCA
GCGCGCTTTGTTGGAGCCTG	CAGGCTCCAACAAAGCGCGC
TATACAAGCCGAGGATCTGA	TCAGATCCTCGGCTTGTATA
CAAGCCAGAAAGTCCCTGGA	TCCAGGGACTTTCTGGCTTG
GTCTGGTCGAGCGTGGCGCG	CGCGCCACGCTCGACCAGAC
TCGCTAATCGCTATAGGCGT	ACGCCTATAGCGATTAGCGA
CAATCTGTCTCTTATGCACG	CGTGCATAAGAGACAGATTG
CAATTAGCGTCCTTATCTGC	GCAGATAAGGACGCTAATTG
GCTGTACGTTTGCTGAGACA	TGTCTCAGCAAACGTACAGC
ACGGGAGTAATCCCAGGATG	CATCCTGGGATTACTCCCGT
CGCGTGTGCTCCGCTTAGTT	AACTAAGCGGAGCACACGCG
GTTCTGATTTAAGCGGGACT	AGTCCCGCTTAAATCAGAAC
CAGTATAGTGTGCGTAGGCT	AGCCTACGCACACTATACTG
GAGGAACCGGAGCCATCTGG	CCAGATGGCTCCGGTTCCTC
CAGTCTCGCTTAGTGTTTCG	CGAAACACTAAGCGAGACTG
ATACGATTCATTCTAAAGAA	TTCTTTAGAATGAATCGTAT
TCGCAGCATATTAATAATTC	GAATTATTAATATGCTGCGA
ATGACGGCGTGGGGTTCCCC	GGGGAACCCCACGCCGTCAT
TGGGTATTTATGAACGAGGT	ACCTCGTTCATAAATACCCA
TATGTTGCAGGATACTAATC	GATTAGTATCCTGCAACATA
GAACCTGCGCGGAGGAGCAC	GTGCTCCTCCGCGCAGGTTC
TTAAGCCAGTCGCGAAGCTA	TAGCTTCGCGACTGGCTTAA
TCCCGAGAAGTAGCAGGTCC	GGACCTGCTACTTCTCGGGA
CTAGGGATAACCATGATAAC	GTTATCATGGTTATCCCTAG
TTGGGGTCGCAGACTTTATT	AATAAAGTCTGCGACCCCAA
CGCTAATCGGATTCCAATAT	ATATTGGAATCCGATTAGCG
TAGGCTCTGTCGAACGTTCT	AGAACGTTCGACAGAGCCTA
CCTTCTCTCGAACTCCTTAG	CTAAGGAGTTCGAGAGAAGG
AAAAATTGCGCTCACCTTTG	CAAAGGTGAGCGCAATTTTT
TCATATACCGTTCAGTTCTC	GAGAACTGAACGGTATATGA
GTAGCTACATACTGTCGAAG	CTTCGACAGTATGTAGCTAC
CTGTCGATAGCAGGAGATCG	CGATCTCCTGCTATCGACAG
GCAGAAGTCCCTCTGTTGAC	GTCAACAGAGGGACTTCTGC
CGCGGGAGGCACCACTTACA	TGTAAGTGGTGCCTCCCGCG
TCGTATCATCGTGTAGTACT	AGTACTACACGATGATACGA
ATGTAGTTTTAAATGCCTAG	CTAGGCATTTAAAACTACAT
GGTCAGGCCCTTTTGGAACG	CGTTCCAAAAGGGCCTGACC
ATTTTTTAAACCACTGTCCT	AGGACAGTGGTTTAAAAAAT
GCCTTATGTCTATCAGAGAA	TTCTCTGATAGACATAAGGC
TGGCCTGCTCTCTAGTGTAT	ATACACTAGAGAGCAGGCCA
AGCATTTTGCCCCGTATCCG	CGGATACGGGGCAAAATGCT
TCCGTAGACCAGAGAATCGT	ACGATTCTCTGGTCTACGGA
TTCTGTGTGATTTGGCTACT	AGTAGCCAAATCACACAGAA
AGGATCCGCACCAGGCCAGA	TCTGGCCTGGTGCGGATCCT
TGACCATGAGGATCTGATGA	TCATCAGATCCTCATGGTCA
CTGAGTCTGTGCAATACACA	TGTGTATTGCACAGACTCAG
AAGCTAACGGGCATCTACCT	AGGTAGATGCCCGTTAGCTT
TAATCGCGAGTGTCGAAGGA	TCCTTCGACACTCGCGATTA
GTACATTTGGTTTCGATAGT	ACTATCGAAACCAAATGTAC
ATTTTACTGCTTGCTATGGC	GCCATAGCAAGCAGTAAAAT
TTTAGTTTAACCATCGTGGC	GCCACGATGGTTAAACTAAA
AGTTGTTCGTTGGGAACCTA	TAGGTTCCCAACGAACAACT
TGCTCCCTCTTATAAGACCT	AGGTCTTATAAGAGGGAGCA
AAGCTTCCATGTTCACAGGT	ACCTGTGAACATGGAAGCTT
CAGCAGGGGGGTGCTGACCT	AGGTCAGCACCCCCCTGCTG
ACAATGATAAACTGGGAGTC	GACTCCCAGTTTATCATTGT
ACTTACTGCACCATGAATGG	CCATTCATGGTGCAGTAAGT
GTCAAAAGGCTCCGGTAGCA	TGCTACCGGAGCCTTTTGAC
CTTCTATCGCAGTCGTAACC	GGTTACGACTGCGATAGAAG
AACGTTGGCTCTGAGACTGT	ACAGTCTCAGAGCCAACGTT
GGAGGCAATAGCAATTGAAA	TTTCAATTGCTATTGCCTCC
GCTCACAACCGTGAGACCGG	CCGGTCTCACGGTTGTGAGC
TGTCGGCCTTCCCTATTCAG	CTGAATAGGGAAGGCCGACA
ACCGCTAAGTGTCCCATTCG	CGAATGGGACACTTAGCGGT
ACCAGAGACGGCTGAGCACT	AGTGCTCAGCCGTCTCTGGT
GCTGGGAAACTCCGTTTACC	GGTAAACGGAGTTTCCCAGC
ACTGCTCGATGTTCACACGA	TCGTGTGAACATCGAGCAGT
GAGGTCCCCAAAGCCTTTTG	CAAAAGGCTTTGGGGACCTC
GTTTTAATGATCGAGATGGT	ACCATCTCGATCATTAAAAC
ACGTCTAAGTTGGACAGTGG	CCACTGTCCAACTTAGACGT
ATACATGACATATCAGGTAT	ATACCTGATATGTCATGTAT
CTAAGTTAAGTATCGACATG	CATGTCGATACTTAACTTAG
TCCATAGGGTAATCATCTAA	TTAGATGATTACCCTATGGA
TGCAATTGATTGTTCCATCG	CGATGGAACAATCAATTGCA
TGGCGGATGGGATAGGTAGT	ACTACCTATCCCATCCGCCA
GGAGCGGGTACCAATTATGA	TCATAATTGGTACCCGCTCC
AATGGCTCCACGGAAATCAG	CTGATTTCCGTGGAGCCATT
TGCGGAACCTTTGTCGGTCC	GGACCGACAAAGGTTCCGCA
CGAGACTCTTTTGTTCGCTG	CAGCGAACAAAAGAGTCTCG
CGGAAGGTTCTAACTATTTG	CAAATAGTTAGAACCTTCCG
GTACGACAGATGTAAAAGCC	GGCTTTTACATCTGTCGTAC
CCCAGGGGCTCAATACTTGG	CCAAGTATTGAGCCCCTGGG
TTACGTTGAACCGCACAAAT	ATTTGTGCGGTTCAACGTAA
GGTTTATAGGCTAAGGGGGC	GCCCCCTTAGCCTATAAACC
GGCTGCGATACGGCTGTATC	GATACAGCCGTATCGCAGCC
CGAAAGAGGGCCTGGTGCCA	TGGCACCAGGCCCTCTTTCG
CTGACTTAGGAGTTTGATGA	TCATCAAACTCCTAAGTCAG
TGCGTGAGTAAGCTCTCTGA	TCAGAGAGCTTACTCACGCA
AAGCATTTTGCCTGTCCCCA	TGGGGACAGGCAAAATGCTT
ATGGTGTATGGCACTCTCTA	TAGAGAGTGCCATACACCAT
TGGGGGTGTATGCAGACTAG	CTAGTCTGCATACACCCCCA
GGTCAACCGGTCGCATTTTA	TAAAATGCGACCGGTTGACC
TTGTGTTAGACAGGGGAGCT	AGCTCCCCTGTCTAACACAA
GAGAAGGGTGGGTGTGTGCG	CGCACACACCCACCCTTCTC
CGCATCTGACTCTACCGTGT	ACACGGTAGAGTCAGATGCG
CCCTTGCTTTGTTAAGTAAA	TTTACTTAACAAAGCAAGGG
TGCTTCCCTTAGATCATCTA	TAGATGATCTAAGGGAAGCA
GATGATGATCACCTAGAGTC	GACTCTAGGTGATCATCATC
GTCTCCGCGTAGATGAGTCT	AGACTCATCTACGCGGAGAC
TGAATTTTTGACCATTGTAC	GTACAATGGTCAAAAATTCA
TGGTCGATGTGGCAATTCTT	AAGAATTGCCACATCGACCA
AAAAAGAGCATAACTCATTT	AAATGAGTTATGCTCTTTTT
TCGATTTCATCCTCTGTGCA	TGCACAGAGGATGAAATCGA
GTCCGCCGTGTGCCCGGATT	AATCCGGGCACACGGCGGAC
CCGACTGCGCCTTCTACCAA	TTGGTAGAAGGCGCAGTCGG
TCCTTACAACTGGGCACAGG	CCTGTGCCCAGTTGTAAGGA
CCCGGATTTCGATATGTAAT	ATTACATATCGAAATCCGGG
CGAATGGACGGCAGGCCGTC	GACGGCCTGCCGTCCATTCG
TGGCTAGTATGACGCAGGGC	GCCCTGCGTCATACTAGCCA
ACTGCCGAGTAAATTGCTGC	GCAGCAATTTACTCGGCAGT
AAGTAGGTTGTAGAGCCTGT	ACAGGCTCTACAACCTACTT
TTTACTTGACTGTGCGAAGC	GCTTCGCACAGTCAAGTAAA
ACGATGATCGTATTTTGTCC	GGACAAAATACGATCATCGT
CAAGCCATACACCTGTGAGG	CCTCACAGGTGTATGGCTTG
TGGGCCAACTTAAAAGGAAG	CTTCCTTTTAAGTTGGCCCA
GCAGACCCCGACTTGAACTA	TAGTTCAAGTCGGGGTCTGC
CTGACACTTGCGGGCAGTGC	GCACTGCCCGCAAGTGTCAG
TATGGGGTCAATGACCGAGT	ACTCGGTCATTGACCCCATA
TCTGGAAATTATTGGCATCC	GGATGCCAATAATTTCCAGA
ACCTGTCACCGGAGCTCGTC	GACGAGCTCCGGTGACAGGT
GCCGCGCTACACATGATGAG	CTCATCATGTGTAGCGCGGC
CAGTACACCCGCAGCGCTCG	CGAGCGCTGCGGGTGTACTG
GTGTATACTTACGCCTTTGC	GCAAAGGCGTAAGTATACAC
CGACACTCAGTGCTAGAATG	CATTCTAGCACTGAGTGTCG
AAGGCGATAATTGGCGGGCT	AGCCCGCCAATTATCGCCTT
CAGAGTTTTTACGGTTGTGC	GCACAACCGTAAAAACTCTG
GGATGTCGAACACAGCCTGT	ACAGGCTGTGTTCGACATCC
GGGCGGCGGAGGGACGTCCT	AGGACGTCCCTCCGCCGCCC
CGGCTGGCCGTCCCTATTTT	AAAATAGGGACGGCCAGCCG
TCGAGGTTGGCTGGCTCTTA	TAAGAGCCAGCCAACCTCGA
CGACGCTGAGGGACCGTCTT	AAGACGGTCCCTCAGCGTCG
TTACCTATACGGGGCGTGAA	TTCACGCCCCGTATAGGTAA
ACCCTGTTCTCGCGGTCTCC	GGAGACCGCGAGAACAGGGT
CCGCTACGCTTCTACCTGTA	TACAGGTAGAAGCGTAGCGG
TTAGCAGGGAGTGCGTTCAA	TTGAACGCACTCCCTGCTAA
CACAGAGCGGAGTGTATCAA	TTGATACACTCCGCTCTGTG
GCATAATTGGTCTATTTCAG	CTGAAATAGACCAATTATGC
TTTATTATACGCAATGCAAA	TTTGCATTGCGTATAATAAA
TTCATATGCCGTTGTTCCGG	CCGGAACAACGGCATATGAA
AATCTCCGACTCCTTAACAA	TTGTTAAGGAGTCGGAGATT
TTGGTTAACTCAGTACACGG	CCGTGTACTGAGTTAACCAA
ACGACAATGAGTCTTCAGAT	ATCTGAAGACTCATTGTCGT
GGGCGGTCCAATGAGTAGCT	AGCTACTCATTGGACCGCCC
GTAAGTTACTTATGGCATAT	ATATGCCATAAGTAACTTAC
ATCCCGACTTGCCCACAGAA	TTCTGTGGGCAAGTCGGGAT
CAACCCGTGTGCCCCTGTGC	GCACAGGGGCACACGGGTTG
GCTTTGGTCTAGCCACTCTC	GAGAGTGGCTAGACCAAAGC
CAAGCCCCACTGACCGAACA	TGTTCGGTCAGTGGGGCTTG
AATAGGCCCCGAACCGCACC	GGTGCGGTTCGGGGCCTATT
GGTTATTCTAACCGTTTCCG	CGGAAACGGTTAGAATAACC
ATTAACCCCGGCCCGATACC	GGTATCGGGCCGGGGTTAAT
CGTAGGGTCTAATACAGAAG	CTTCTGTATTAGACCCTACG
TTTGCTCCATGTATGAGCTT	AAGCTCATACATGGAGCAAA
CCACTGTCGCTACTAAGGCT	AGCCTTAGTAGCGACAGTGG
TCCCAACGGACCGATGTCTG	CAGACATCGGTCCGTTGGGA
ATATGTGGAGCGTCAGTTTT	AAAACTGACGCTCCACATAT
GCTTCACTCCAAAATGCCAT	ATGGCATTTTGGAGTGAAGC
AATTATAGGTGACTGGTGAC	GTCACCAGTCACCTATAATT
TCGCCCAACCAACCCTATTC	GAATAGGGTTGGTTGGGCGA
CGACCTTGAGCCAATGTGTC	GACACATTGGCTCAAGGTCG
CATGAATAGGATATCACCGT	ACGGTGATATCCTATTCATG
GCTGCTCCCACGCGTGAATA	TATTCACGCGTGGGAGCAGC
GCCCCGTCGATGACCACCCG	CGGGTGGTCATCGACGGGGC
AAAATACAAAGGTCCCGAGA	TCTCGGGACCTTTGTATTTT
GGCGCATCTATATCGATCGT	ACGATCGATATAGATGCGCC
GGGTGCCGTACCATACAACT	AGTTGTATGGTACGGCACCC
CTCTCCCCTTCAGTATATAA	TTATATACTGAAGGGGAGAG
GGACTTTGCATTGAAATTGC	GCAATTTCAATGCAAAGTCC
TCCCGAGAAACGGGGTCGTG	CACGACCCCGTTTCTCGGGA
GAGAGCATGCCTTACACATA	TATGTGTAAGGCATGCTCTC
AGTATCGGGCCGCACACGCG	CGCGTGTGCGGCCCGATACT
GCATAGATCGGTAGTGTGAC	GTCACACTACCGATCTATGC
TTACTTAGAGTATATACGCG	CGCGTATATACTCTAAGTAA
GCTAGAGAATCATCCCTCCG	CGGAGGGATGATTCTCTAGC
AATAAGCGCAGGAGGCCCAG	CTGGGCCTCCTGCGCTTATT
TACATACATGATATTTTGGA	TCCAAAATATCATGTATGTA
TGTGTCATGGGCTCTTAGTA	TACTAAGAGCCCATGACACA
CTTATGGTAAATCTTGCGAG	CTCGCAAGATTTACCATAAG
TGTATCTGGTAGGCCGGACG	CGTCCGGCCTACCAGATACA
GTCGAAATGACTATTAGCCA	TGGCTAATAGTCATTTCGAC
GAAAACTTGGTCGATGTAGG	CCTACATCGACCAAGTTTTC
TAGTTGATTTTTGTCTGTGA	TCACAGACAAAAATCAACTA
CGCGTCCGAAAAATCGCGCA	TGCGCGATTTTTCGGACGCG
CACGTTGGAAGCCACACGAA	TTCGTGTGGCTTCCAACGTG
AGGCTGGCAGAGCTTCATGT	ACATGAAGCTCTGCCAGCCT
ATACGTCAATTACCCCAATC	GATTGGGGTAATTGACGTAT
AGATCCATTGCGCGAAGTGG	CCACTTCGCGCAATGGATCT
TTCGAAGCATCAACGTCAGC	GCTGACGTTGATGCTTCGAA
GACCTTGCAGTAGCTGCCGG	CCGGCAGCTACTGCAAGGTC
TCCAGTACTTACACAGGACC	GGTCCTGTGTAAGTACTGGA
AAGCTGGGTTTCATGTAGCG	CGCTACATGAAACCCAGCTT
ACTCAAGCCAGCGTAAAGCT	AGCTTTACGCTGGCTTGAGT
TGATCTAGTGTCTGTCTGGG	CCCAGACAGACACTAGATCA
GTGGCATGCCACATCTATAG	CTATAGATGTGGCATGCCAC
ACGAGCTCGTCTATGGGTAT	ATACCCATAGACGAGCTCGT
ATGCAGAGCCTCGTCCTAGC	GCTAGGACGAGGCTCTGCAT
TAAAGCGCCTTCTACTCACG	CGTGAGTAGAAGGCGCTTTA
ATGGATCAGTGATAGCGTTC	GAACGCTATCACTGATCCAT
AATGACGCGCAACATAGGAG	CTCCTATGTTGCGCGTCATT
GAGAGCTTATCTGATTGCTG	CAGCAATCAGATAAGCTCTC
TTATGTTGGCTCGGCACACG	CGTGTGCCGAGCCAACATAA
ATACAGGTTAGCTAGAAAAA	TTTTTCTAGCTAACCTGTAT
TTCGATCCCATGTGTCGGCG	CGCCGACACATGGGATCGAA
GAGCGACTAGAGACATCTGC	GCAGATGTCTCTAGTCGCTC
TAGGGTGGCCGGCGGGGGTC	GACCCCCGCCGGCCACCCTA
GCATCCGGTTACTCTCGTGA	TCACGAGAGTAACCGGATGC
ATATGGAGACAAGCATGGGG	CCCCATGCTTGTCTCCATAT
CGGTGACGAATAAATGACCA	TGGTCATTTATTCGTCACCG
TCTACCAAGAATAGTACACG	CGTGTACTATTCTTGGTAGA
GTCACCCATTCTCGCACTGA	TCAGTGCGAGAATGGGTGAC
ATGGTGCTTCCAGTAACGCC	GGCGTTACTGGAAGCACCAT
AATAGCCGGTATAGTACTCT	AGAGTACTATACCGGCTATT
TTTCGACGTTTAATGCTGGG	CCCAGCATTAAACGTCGAAA
AGCAGCCGTAAAGAGAGCTA	TAGCTCTCTTTACGGCTGCT
CGAACACTCGGGACTTTAAT	ATTAAAGTCCCGAGTGTTCG
AATGCGTGTGTGATGCTCCA	TGGAGCATCACACACGCATT
CATCCCAGTACGTCACCAGA	TCTGGTGACGTACTGGGATG
CATCAGTCACACCCCGCCTT	AAGGCGGGGTGTGACTGATG
TTTCTGGGCCTATCGGGCGT	ACGCCCGATAGGCCCAGAAA
CGGGGGTGCTCTCAATGGGC	GCCCATTGAGAGCACCCCCG
GACTGATGATTTAGCTCGAG	CTCGAGCTAAATCATCAGTC
TGCCCTGCGATGCTTGATAC	GTATCAAGCATCGCAGGGCA
GGGCCAAAAGTGGGCACCAT	ATGGTGCCCACTTTTGGCCC
GTATCAGGGTCTTCGGCTGT	ACAGCCGAAGACCCTGATAC
TTGGCCTTTATCCATAATGG	CCATTATGGATAAAGGCCAA
GAAGAAAATAGTAGAGCAAC	GTTGCTCTACTATTTTCTTC
CAGCGCCACAGCGGGGCTAA	TTAGCCCCGCTGTGGCGCTG
TTGAAACAGGTTTTCGGCAT	ATGCCGAAAACCTGTTTCAA
CCTAAAACGCACTGAGAGTA	TACTCTCAGTGCGTTTTAGG
TCGACTCATGTAACGACAGT	ACTGTCGTTACATGAGTCGA
AGACGCTTTACACGGCTCCC	GGGAGCCGTGTAAAGCGTCT
AAGCTTGAATCGAGGGAGGC	GCCTCCCTCGATTCAAGCTT
ATCATTTACCTGATAGCTTC	GAAGCTATCAGGTAAATGAT
CACATTTGTAACGTGTAGGC	GCCTACACGTTACAAATGTG
ATACCTTCTATAACCCCGCT	AGCGGGGTTATAGAAGGTAT
CGTAATTGACCGAGCTCTCA	TGAGAGCTCGGTCAATTACG
AATGTGGTTAACCTTAGCGG	CCGCTAAGGTTAACCACATT
ACATGTATTGGTGCCGGACC	GGTCCGGCACCAATACATGT
ATGCCTCTCATGATGCTAAG	CTTAGCATCATGAGAGGCAT
CCAACGCAACCACCCCGGCC	GGCCGGGGTGGTTGCGTTGG
AGATCCCCATTCAACTGCGT	ACGCAGTTGAATGGGGATCT
GATGTGAATCCCTTCACACT	AGTGTGAAGGGATTCACATC
GGAAGATGAGATGTAGGCAT	ATGCCTACATCTCATCTTCC
TCTTGATTTTAGCTTTTACG	CGTAAAAGCTAAAATCAAGA
GAGCTGCGCTACCGGTTCCA	TGGAACCGGTAGCGCAGCTC
GATGAACATTCAAGACGCAC	GTGCGTCTTGAATGTTCATC
ACTCCCCTAGTTGGAAGTCA	TGACTTCCAACTAGGGGAGT
CTCTGCCGCGAGCGTATTAA	TTAATACGCTCGCGGCAGAG
CTGGGGAATGACAAACCAGC	GCTGGTTTGTCATTCCCCAG
TCGTCCAGTCGCCGGCGAGC	GCTCGCCGGCGACTGGACGA
ATATATGGACCTCAGCGTCG	CGACGCTGAGGTCCATATAT
TTCTATTTCTGACACCACCG	CGGTGGTGTCAGAAATAGAA
CTCTCGGAATGGGTGAGGAA	TTCCTCACCCATTCCGAGAG
GTCGAATGATAGAGTGCATG	CATGCACTCTATCATTCGAC
GGTACCGAAATTGAGTTATA	TATAACTCAATTTCGGTACC
ACATCTCTTAGTGTCCTCCA	TGGAGGACACTAAGAGATGT
ACACTAAACTATTTGCCCGA	TCGGGCAAATAGTTTAGTGT
GACTTACACGTTTTATCACA	TGTGATAAAACGTGTAAGTC
CGACATCCAAGTGGCTTAAC	GTTAAGCCACTTGGATGTCG
TTGTCGGGAGATTCGCGAAT	ATTCGCGAATCTCCCGACAA
TTATCTAACACTGAACTGTA	TACAGTTCAGTGTTAGATAA
TAATCAGGAAACGTCTGGAG	CTCCAGACGTTTCCTGATTA
GCGGTAACATGGCTTTTGAG	CTCAAAAGCCATGTTACCGC
AACGCCCGTGTGGGGTCCCT	AGGGACCCCACACGGGCGTT
CGGGCTAACGAGCCGCAAGA	TCTTGCGGCTCGTTAGCCCG
GAAATGTACACCCCTTAGAT	ATCTAAGGGGTGTACATTTC
TTCGTCAGCGGTCCACCCGC	GCGGGTGGACCGCTGACGAA
CATATCTTTTTCAAAGCGAT	ATCGCTTTGAAAAAGATATG
GCAACGCTTCTTACTGTTTG	CAAACAGTAAGAAGCGTTGC
ATGCCTGGGAATGAAGGATC	GATCCTTCATTCCCAGGCAT
ATCCGTACCGGCCAGCCAAT	ATTGGCTGGCCGGTACGGAT
CAAGGGGCCGGACTGTACGT	ACGTACAGTCCGGCCCCTTG
GTCCGGCCTACTCCTCAATG	CATTGAGGAGTAGGCCGGAC
TCTCTCCTTCTGTGTCGTCT	AGACGACACAGAAGGAGAGA
ATGCGGCATGTTAGCCAAAT	ATTTGGCTAACATGCCGCAT
TCGAAACGCCGTTTGTAAAG	CTTTACAAACGGCGTTTCGA
ATACGACATCCACAGAAACG	CGTTTCTGTGGATGTCGTAT
CCTAGCTGATCGCCGTTTGT	ACAAACGGCGATCAGCTAGG
TCAAGGCGAAAATCTCAGAG	CTCTGAGATTTTCGCCTTGA
TTTAGTACCTTCGGCTACAA	TTGTAGCCGAAGGTACTAAA
GATTACGTCAGGTCTTAGAC	GTCTAAGACCTGACGTAATC
ATTACACATGCGGATGCTCC	GGAGCATCCGCATGTGTAAT
CACCTACCTTATACCCGCTC	GAGCGGGTATAAGGTAGGTG
GTGACACTTTCGCCCTGCTT	AAGCAGGGCGAAAGTGTCAC
GAGTTTCCGACCCCGTGAGT	ACTCACGGGGTCGGAAACTC
TAGCCGCCGGGCCACTGTAA	TTACAGTGGCCCGGCGGCTA
ATCATGTAGTTGGCTCATAG	CTATGAGCCAACTACATGAT
ATATGATTGTCCCCCTAGCA	TGCTAGGGGGACAATCATAT
TTCAGTTTTTATTCCCCGTT	AACGGGGAATAAAAACTGAA
CGCAAATATATGGTGAACGA	TCGTTCACCATATATTTGCG
CAAGGAGTCACGACCACAGA	TCTGTGGTCGTGACTCCTTG
GGTCATAGCACGCACTACAA	TTGTAGTGCGTGCTATGACC
TTCCTGCGGCCTCAACTCAC	GTGAGTTGAGGCCGCAGGAA
TCGCATTTCGCCGTGAACGC	GCGTTCACGGCGAAATGCGA
CCCAAGCCCAGACTGATACA	TGTATCAGTCTGGGCTTGGG
CAGTGGGGGGCGTACCAACG	CGTTGGTACGCCCCCCACTG
GTAGTTTCACTTACAAGAAC	GTTCTTGTAAGTGAAACTAC
GGTATCCGATATAAACACGC	GCGTGTTTATATCGGATACC
ATTTCCGACCCAGGAAGGGC	GCCCTTCCTGGGTCGGAAAT
GAAGAGGGCACTGATCTGCA	TGCAGATCAGTGCCCTCTTC
GGCCTACTAGCCAAGGGGCA	TGCCCCTTGGCTAGTAGGCC
CCTATAATATGAGCGACTAT	ATAGTCGCTCATATTATAGG
TTCTCGGAATATCACCCTTT	AAAGGGTGATATTCCGAGAA
CTGTATCAAGCAAACCCGCT	AGCGGGTTTGCTTGATACAG
GTTTCCCGAAATGGTTTCTA	TAGAAACCATTTCGGGAAAC
GCCTATACCCTATCTGGGCC	GGCCCAGATAGGGTATAGGC
TTGGTAATCGACAAAAGAGA	TCTCTTTTGTCGATTACCAA
TACGACTATACTTGAGAATG	CATTCTCAAGTATAGTCGTA
TGTCAGTTACCTCAACTAGA	TCTAGTTGAGGTAACTGACA
GGGAGAACATCTCCTTTCTC	GAGAAAGGAGATGTTCTCCC
TTAGTATCCATGAGCGGCTG	CAGCCGCTCATGGATACTAA
CGAGACAATCTAAATAAGCG	CGCTTATTTAGATTGTCTCG
ATCGCGCGGTCGAGCCACGG	CCGTGGCTCGACCGCGCGAT
GGAAATGTCCAAATGGCTCC	GGAGCCATTTGGACATTTCC
ATAGAATATATCGTTTGCCG	CGGCAAACGATATATTCTAT
AGATGACGCAAGTCTGCGAC	GTCGCAGACTTGCGTCATCT
AGGAGAACGAGTACCCCCCG	CGGGGGGTACTCGTTCTCCT
GTTCTTCGCAGGAAGGTTAC	GTAACCTTCCTGCGAAGAAC
GTGCAACCGGCAAACTGCAA	TTGCAGTTTGCCGGTTGCAC
GAGGGCACTCGGTTCGACAG	CTGTCGAACCGAGTGCCCTC
AGGCCGCCAAAGGAGGAACG	CGTTCCTCCTTTGGCGGCCT
GTTAGGACCTGAGCGGAGCT	AGCTCCGCTCAGGTCCTAAC
ATAGGAGGAGCTTTCTTCAT	ATGAAGAAAGCTCCTCCTAT
TCGAATGTTAACATGATATA	TATATCATGTTAACATTCGA
ATAGTAGATACCAAAAAAAC	GTTTTTTTGGTATCTACTAT
TGCCGGAACCGCCTGGAACC	GGTTCCAGGCGGTTCCGGCA
CGACGCGGTCAATTACGCGC	GCGCGTAATTGACCGCGTCG
CGCCAACCCACGATTCCTTG	CAAGGAATCGTGGGTTGGCG
ACGGATTCGCAATCTCCATA	TATGGAGATTGCGAATCCGT
CCCACTGCTGATTTTGATGT	ACATCAAAATCAGCAGTGGG
TGCGAAGCTTAGTTACTATC	GATAGTAACTAAGCTTCGCA
ATGGGACCCCCAGGCTTTAA	TTAAAGCCTGGGGGTCCCAT
ACATAGTGGATTAGACAGAG	CTCTGTCTAATCCACTATGT
CCGCCGGAGCAGGATTGTCG	CGACAATCCTGCTCCGGCGG
TAGTTATAACTGCTGTTTGG	CCAAACAGCAGTTATAACTA
TTTGAAGGAATAAACAACTC	GAGTTGTTTATTCCTTCAAA
ATGGCACCGTGGGTAGTCTA	TAGACTACCCACGGTGCCAT
AAGGCGCTAGCGCCTGGATC	GATCCAGGCGCTAGCGCCTT
GGATAAAAATTATTCTATAT	ATATAGAATAATTTTTATCC
TGGCTGTTCGCCATCCCGTC	GACGGGATGGCGAACAGCCA
TGGTACTAGAGTCCCCGTTT	AAACGGGGACTCTAGTACCA
CACCCGATTGAAATCACACC	GGTGTGATTTCAATCGGGTG
TCTCCATGTGCGGTCGGTAG	CTACCGACCGCACATGGAGA
TACTATCATGATTACTTGAA	TTCAAGTAATCATGATAGTA
GAGAACCCGATCCGGCATTG	CAATGCCGGATCGGGTTCTC
CGTTGCCGAGAACCGGAAGC	GCTTCCGGTTCTCGGCAACG
TTCGTTAACGCAACAGCTGT	ACAGCTGTTGCGTTAACGAA
CAGTAAAATGTATCCACCGT	ACGGTGGATACATTTTACTG
TCGTACACCTGAGCCAGGGC	GCCCTGGCTCAGGTGTACGA
GGATGACAGAGGTTTCTTCA	TGAAGAAACCTCTGTCATCC
TGATACCCATTAGTCTGTTA	TAACAGACTAATGGGTATCA
TAATCACTTCAGAAACTCGT	ACGAGTTTCTGAAGTGATTA
GTATCGTTGACAAAGGGCAC	GTGCCCTTTGTCAACGATAC
AGAAATATCTCACCAGCCAC	GTGGCTGGTGAGATATTTCT
CTTACAACACCAACATCTCC	GGAGATGTTGGTGTTGTAAG
TACTAGAGTCCACTTCTCGG	CCGAGAAGTGGACTCTAGTA
AGATATACAAAATGCAGCCT	AGGCTGCATTTTGTATATCT
TCCTGATAGAGAACCAATGA	TCATTGGTTCTCTATCAGGA
GGAGGGGTAGGAAGGGTTCG	CGAACCCTTCCTACCCCTCC
TGCATGGTCGACCGTAGATT	AATCTACGGTCGACCATGCA
ATCATTCGGCGTTTTTCTGA	TCAGAAAAACGCCGAATGAT
TCCGCCTAACTGACCCAGCT	AGCTGGGTCAGTTAGGCGGA
CCTGGCGAGGGACATTTTTA	TAAAAATGTCCCTCGCCAGG
GGCGCCGCTCGGAGGTCCGA	TCGGACCTCCGAGCGGCGCC
CACAGATCAGTACACCTTTT	AAAAGGTGTACTGATCTGTG
ATAGGGTGCCTCTTGAAGGC	GCCTTCAAGAGGCACCCTAT
CGACGCTAAGGGCCGATTTC	GAAATCGGCCCTTAGCGTCG
TGGCATCCAATGTGTCGGAT	ATCCGACACATTGGATGCCA
CCTAGACTATCCGCCGTCGA	TCGACGGCGGATAGTCTAGG
AGCATGTGTCAGATGAGGAT	ATCCTCATCTGACACATGCT
AGCTACTTGCTCCAGCCACG	CGTGGCTGGAGCAAGTAGCT
CGAGCCATAGATCACGCTTT	AAAGCGTGATCTATGGCTCG
GCGTCCAACGCAATAGCATT	AATGCTATTGCGTTGGACGC
GATGTGTGTGATACTTTAGT	ACTAAAGTATCACACACATC
CACACCAGCTGAACGTACGG	CCGTACGTTCAGCTGGTGTG
AGGGTGTCTCAGAGAGTCAC	GTGACTCTCTGAGACACCCT
GTGTAACCCCTAGGATGCAA	TTGCATCCTAGGGGTTACAC
GATCCTAGGGAACGATTCTG	CAGAATCGTTCCCTAGGATC
GGCTCTTATTGGTAGGAGGG	CCCTCCTACCAATAAGAGCC
ATGTGTTGAGATAATGAAGG	CCTTCATTATCTCAACACAT
GTGCATTTGATTGAGAGTTG	CAACTCTCAATCAAATGCAC
TGCTATGAGCATTACTATTC	GAATAGTAATGCTCATAGCA
TTTCAGTCTTTTCGAATATC	GATATTCGAAAAGACTGAAA
AAGGTTTTTCTAATCTCCTG	CAGGAGATTAGAAAAACCTT
CTGCATTCAGAAAAGGAGCA	TGCTCCTTTTCTGAATGCAG
CTAGATAAGTTTCGCGAACC	GGTTCGCGAAACTTATCTAG
CGTACGAAACACGGGGTTTA	TAAACCCCGTGTTTCGTACG
GCGAATGACATCATAACAGC	GCTGTTATGATGTCATTCGC
AGCGAGAGCCCCAGCACACG	CGTGTGCTGGGGCTCTCGCT
AGGATTCGCTATCCCGTCTA	TAGACGGGATAGCGAATCCT
TACTTTATTTGTCTGACAAG	CTTGTCAGACAAATAAAGTA
GTAAGTGTTGATGTCTGACT	AGTCAGACATCAACACTTAC
CCGGAGTACATGTAGACGTA	TACGTCTACATGTACTCCGG
GGAACCCTATGGCGCTCAGA	TCTGAGCGCCATAGGGTTCC
GTTGCCGGATGAAGTATTAC	GTAATACTTCATCCGGCAAC
GGCTGATTGTGAATGAATTA	TAATTCATTCACAATCAGCC
GACGCAAACATAACGCGATT	AATCGCGTTATGTTTGCGTC
CCTGTTCCATGTATCGACCG	CGGTCGATACATGGAACAGG
CCTGACACATGACCACTTTG	CAAAGTGGTCATGTGTCAGG
CAATGGCCATCCTCAGTAAG	CTTACTGAGGATGGCCATTG
CGGATTGAGAAAACAGCGCA	TGCGCTGTTTTCTCAATCCG
TTAGTGACGATTTATTGCCG	CGGCAATAAATCGTCACTAA
TCATGGGCACGAGGAAAGTG	CACTTTCCTCGTGCCCATGA
CGGCTATAGCACGAGCGTTG	CAACGCTCGTGCTATAGCCG
AGCGTCTGTCGCCCTCTAGG	CCTAGAGGGCGACAGACGCT
TATCGTGACCCTTCCTGACG	CGTCAGGAAGGGTCACGATA
CAACACCTCCTGTTAACCAC	GTGGTTAACAGGAGGTGTTG
GCAACAAAAGATTGAATGGT	ACCATTCAATCTTTTGTTGC
GGAGCAACTCGACTCAGATA	TATCTGAGTCGAGTTGCTCC
TAACGAATCGTATAACGATC	GATCGTTATACGATTCGTTA
CCACTCACCCAAGAATGGCA	TGCCATTCTTGGGTGAGTGG
GCGTACAAACCGACCAGGTG	CACCTGGTCGGTTTGTACGC
CCGTCATAGAAGAAATATGA	TCATATTTCTTCTATGACGG
CCAGGTTGGAACCGTGTTCT	AGAACACGGTTCCAACCTGG
TTCTGATAATGGGTCTCCGG	CCGGAGACCCATTATCAGAA
CTACGAGCACGGAGGTACAT	ATGTACCTCCGTGCTCGTAG
TCCCTGAATCTAATTCATAC	GTATGAATTAGATTCAGGGA
ATAGTCTTTGGACCTGTACA	TGTACAGGTCCAAAGACTAT
TCACTCTGAGAGTAGGTCCC	GGGACCTACTCTCAGAGTGA
ATGAGCGGTGCGATACGCCT	AGGCGTATCGCACCGCTCAT
CCGAAATTTTGCTGGCTCTA	TAGAGCCAGCAAAATTTCGG
ATTGAACTCCGTGCAAAATC	GATTTTGCACGGAGTTCAAT
AAATTTAGGCGTAGTATAAC	GTTATACTACGCCTAAATTT
CAGAGAAACCTCTTCCGCGT	ACGCGGAAGAGGTTTCTCTG
CGAGTATACAATTAGACAGT	ACTGTCTAATTGTATACTCG
ATGCGGGGGCCAAAGCTAAG	CTTAGCTTTGGCCCCCGCAT
GTATATCTAGAGTCTTCAGG	CCTGAAGACTCTAGATATAC
CCTCAAGGGGTTTGGTTATG	CATAACCAAACCCCTTGAGG
TATTCCGATCTCGCCCGGGG	CCCCGGGCGAGATCGGAATA
CTGGGGGAACAATCGTCCGG	CCGGACGATTGTTCCCCCAG
TGAGTCAACTGTCTTTGAGC	GCTCAAAGACAGTTGACTCA
GTTCAGGAGGTCGGCCTCTT	AAGAGGCCGACCTCCTGAAC
GCAACCAAGACCAGGATCTC	GAGATCCTGGTCTTGGTTGC
TATGTGTAAATTCATGTCAA	TTGACATGAATTTACACATA
GTCGTCCTCACGAAGAGCCC	GGGCTCTTCGTGAGGACGAC
CTGACAATCGCTGTATAAAC	GTTTATACAGCGATTGTCAG
TCGCGCCTTATGTTTATAGC	GCTATAAACATAAGGCGCGA
TACGTCGGATTCAGGTAACT	AGTTACCTGAATCCGACGTA
TAGTGGCTCTAGTTCCGTAG	CTACGGAACTAGAGCCACTA
ATCCGAACGTGTCGTATTAA	TTAATACGACACGTTCGGAT
AAAGAGAAGGATGACAGGAA	TTCCTGTCATCCTTCTCTTT
TGGGACGAACCGAACCCCCC	GGGGGGTTCGGTTCGTCCCA
CCACACCGCTCTTCCGTTGA	TCAACGGAAGAGCGGTGTGG
TGACGCTCGGGCAGAGAAGA	TCTTCTCTGCCCGAGCGTCA
CGCCACGAAGAGGATCCAAA	TTTGGATCCTCTTCGTGGCG
CGTGTGATGGATAGACTCCT	AGGAGTCTATCCATCACACG
TTGAACGTAACGCACGTCCT	AGGACGTGCGTTACGTTCAA
AGGCATTACACTCAAGGACT	AGTCCTTGAGTGTAATGCCT
TCGGAGTATGACAGAATTTC	GAAATTCTGTCATACTCCGA
GGGAGTTCATTGCCAGGACC	GGTCCTGGCAATGAACTCCC
CAATTGCACACAGTAGCCTT	AAGGCTACTGTGTGCAATTG
AACTAGCCTCTGTCGGTCTG	CAGACCGACAGAGGCTAGTT
AACTCTCAATGTAGGGCGTT	AACGCCCTACATTGAGAGTT
TGGCAAACATGATTTTGAGT	ACTCAAAATCATGTTTGCCA
TCACCGCTTTAATGAGGCAT	ATGCCTCATTAAAGCGGTGA
GGGGGGTAGGTCCGATGACT	AGTCATCGGACCTACCCCCC
ATTCAGAGTCATTAGAGTTA	TAACTCTAATGACTCTGAAT
GCGAAATACGCGTCCGAAGC	GCTTCGGACGCGTATTTCGC
GTGCGTGAACAACTACGGGT	ACCCGTAGTTGTTCACGCAC
GTCGAGATTACAGAACGATT	AATCGTTCTGTAATCTCGAC
CGCAGAAGGACCTTGGAACC	GGTTCCAAGGTCCTTCTGCG
CATGTGAATAACACCCACTC	GAGTGGGTGTTATTCACATG
TTAGTGACTGAGCGGTATTC	GAATACCGCTCAGTCACTAA
CACACTTCGCTGTTAACTCC	GGAGTTAACAGCGAAGTGTG
GGTTCGCGCGATTTGGAAAA	TTTTCCAAATCGCGCGAACC
CATCCGTGGGCACGGAAGGC	GCCTTCCGTGCCCACGGATG
TAAATGATTGAATGCGCGGA	TCCGCGCATTCAATCATTTA
GGTATCGTTAGCGTCTCCAA	TTGGAGACGCTAACGATACC
GGGGATTTAGCAAAACGCTC	GAGCGTTTTGCTAAATCCCC
CAGCGTAACAAGGTTTGACC	GGTCAAACCTTGTTACGCTG
AGCGTATCGTTTGACCAGAG	CTCTGGTCAAACGATACGCT
TCTAGTACATGCATTCGTGG	CCACGAATGCATGTACTAGA
CCTTTGATGGTTCGTTGTAA	TTACAACGAACCATCAAAGG
CAGTAGCGAAAAATACACTA	TAGTGTATTTTTCGCTACTG
ATCGCGTACGTATTTAAGCC	GGCTTAAATACGTACGCGAT
CGCCCCGCCGTTAGGAACTG	CAGTTCCTAACGGCGGGGCG
CGTTATTTCACGTGGACTGA	TCAGTCCACGTGAAATAACG
TTTATAAGCCCGAAGCGCGT	ACGCGCTTCGGGCTTATAAA
CATCTTTTTTAGGTGGGTGG	CCACCCACCTAAAAAAGATG
AGGTAAGATATTATCTCGAT	ATCGAGATAATATCTTACCT
GGGGATGATAAACAGGATAC	GTATCCTGTTTATCATCCCC
GAGGTGGACTGATAAATCGA	TCGATTTATCAGTCCACCTC
GCATGAAAGCGTCACGATGT	ACATCGTGACGCTTTCATGC
ATTAGATGCCCTATTTACTA	TAGTAAATAGGGCATCTAAT
CTCGTAGGTCACATTTACCT	AGGTAAATGTGACCTACGAG
GATATCTACGGTGTATTTGA	TCAAATACACCGTAGATATC
CAACCTTCGGAATGGCAGAC	GTCTGCCATTCCGAAGGTTG
CGCATAATATCCTCCATCCA	TGGATGGAGGATATTATGCG
CATCGCAACCGCGTTCGGTA	TACCGAACGCGGTTGCGATG
GTTCCCTTAAAATGCTACGG	CCGTAGCATTTTAAGGGAAC
TTAGCCGGTAGAAGCCCTAA	TTAGGGCTTCTACCGGCTAA
GGCCATCAGCGCAAAGCCCA	TGGGCTTTGCGCTGATGGCC
GCAGGGGTGGAGTATTCAAG	CTTGAATACTCCACCCCTGC
ACTCGCGGGGCCAAAGCATC	GATGCTTTGGCCCCGCGAGT
TGGGGACTCTGCTCTCCAGT	ACTGGAGAGCAGAGTCCCCA
TAATGGATCAGGTTAGTTCA	TGAACTAACCTGATCCATTA
GCACACATGGGAATGTGAGG	CCTCACATTCCCATGTGTGC
GTAGATTCAATGAACAGTTT	AAACTGTTCATTGAATCTAC
TATGGGTCGGTTGAGAGTGT	ACACTCTCAACCGACCCATA
TAGGCTTAATGATAGGTTGC	GCAACCTATCATTAAGCCTA
GTGAGGGCACGCATCAGTAG	CTACTGATGCGTGCCCTCAC
CCAATGTGCGCTACTTTTTC	GAAAAAGTAGCGCACATTGG
TACCAGCTCGTATTAAACTC	GAGTTTAATACGAGCTGGTA
GGTGTGGACCGCCATTCGCA	TGCGAATGGCGGTCCACACC
GAGGCTCACGTAACAACCAC	GTGGTTGTTACGTGAGCCTC
AAATCTTATAACCAACGGTC	GACCGTTGGTTATAAGATTT
AAATGGGCCTAATAATGTTC	GAACATTATTAGGCCCATTT
AAAGTAAATAGTAGCCAGTA	TACTGGCTACTATTTACTTT
AGTGTGGAATGATCGGTAGC	GCTACCGATCATTCCACACT
GCATTGGGTAGCTGTGGAGA	TCTCCACAGCTACCCAATGC
GCGTCAATCCGTAGGCCGAT	ATCGGCCTACGGATTGACGC
ATGGAACCGTCCCGCGTATA	TATACGCGGGACGGTTCCAT
CCCGGGTATTTAAGACAACG	CGTTGTCTTAAATACCCGGG
TGCTTATGGTTAATTTGCAG	CTGCAAATTAACCATAAGCA
GTCTTAAGACAAATTCCTCT	AGAGGAATTTGTCTTAAGAC
ACGTCTGGTTAACTCCCGCC	GGCGGGAGTTAACCAGACGT
GTTACTGTAACACTAAGACC	GGTCTTAGTGTTACAGTAAC
GGGTTTTAAGAGACCGTAAC	GTTACGGTCTCTTAAAACCC
GAGCTCAATTCCATCCTTTG	CAAAGGATGGAATTGAGCTC
CCCGTTCCGACGCCTCGTCA	TGACGAGGCGTCGGAACGGG
TCAACTTGCAATTACGCCCC	GGGGCGTAATTGCAAGTTGA
ATAGCTTATTTAATTTACTA	TAGTAAATTAAATAAGCTAT
TGAGCTTAGAATTCGTGGGA	TCCCACGAATTCTAAGCTCA
ATTTTTCCGGGGAGGCGGTA	TACCGCCTCCCCGGAAAAAT
AAATAAATTGGTTCTCCAAT	ATTGGAGAACCAATTTATTT
TGGGAACTTACAGAGTACCC	GGGTACTCTGTAAGTTCCCA
ATCCGTAGTCCTTCGTACGC	GCGTACGAAGGACTACGGAT
TGACAGTGATGATTACGCAT	ATGCGTAATCATCACTGTCA
GATTCCCAGGGAGCGAGAGG	CCTCTCGCTCCCTGGGAATC
TAGTTAGTCACGCCCATTCG	CGAATGGGCGTGACTAACTA
GTTGGGCAAACAATTACTAC	GTAGTAATTGTTTGCCCAAC
GTTGTTACGCGTGCTTAGCG	CGCTAAGCACGCGTAACAAC
GCGTCGTAATATCTGAATCC	GGATTCAGATATTACGACGC
GTACCCGCAACTAGGGACCA	TGGTCCCTAGTTGCGGGTAC
CCTGTTTAGAGGTGAGACTG	CAGTCTCACCTCTAAACAGG
CTTCTGCGCGCGTGTATTAA	TTAATACACGCGCGCAGAAG
GTAATAATAGCACTACCTTA	TAAGGTAGTGCTATTATTAC
GTAGTCGAGATCCTGCTTGT	ACAAGCAGGATCTCGACTAC
CAGCAAGTCAATAGCACTGC	GCAGTGCTATTGACTTGCTG
GGAACATTTGGGGCGGAGAT	ATCTCCGCCCCAAATGTTCC
TTCCACGGGCACCGTGCCCT	AGGGCACGGTGCCCGTGGAA
GAGTCACAAGTAACTAAGAA	TTCTTAGTTACTTGTGACTC
